0000000000000
1111111100000
1111111100000
0000000000000
0000000000000
0000011111111
0000011111111
0000000000000
0000000000000
1111111100000
1111111100000
0000000000000
0000000000000