0000000000000
2200222200000
2200222200000
0000000000000
0000000000000
0000022220022
0000022220022
0000000000000
0000000000000
2200222200000
2200222200000
0000000000000
0000000000000