0000000000000
0000000000000
0022000002200
0022000002200
0000000000000
0000022200000
0000022200000
0000022200000
0000000000000
0022000002200
0022000002200
0000000000000
0000000000000