0000000000000
0000000000000
0011000001100
0011000001100
0000000000000
0000011100000
0000011100000
0000011100000
0000000000000
0011000001100
0011000001100
0000000000000
0000000000000