0000000000000
0000000000000
0000222220000
0000000000000
0010000000100
0010022200100
0010022200100
0010022200100
0010000000100
0000000000000
0000222220000
0000000000000
0000000000000