0000000000000
0000000000000
0011111111100
0020000000200
0020000000200
0020011100200
0020000200200
0011111100200
0000000000200
0000000000200
1111111111100
0000000000000
0000000000000